###########
TT #B@B####
TT ##B#   #
TT #### B #
TTT####   #
# K #######
# C #     #
## ##BBBBB#
# B########
#    ####GT
########TTT