TTTTTTTTTTTTTTTT
TTTT    @    TTT
TTTT C       TTT
TTTTTTTT     TTT
TTTTTTTT TTTTTTT
TTTTTTTT      KT
T        TTT TTT
T  TTTTT TTT TTT
T BTTTTT TTT TTT
T  TT        TTT
T        TT  TTT
T        TT  TTT
TTTTTTTT   B TTT
TTTTTTTTTT   TTT
G          TTTTT
TTTTTTTTTTTTTTTT
