TTTTTTTTTTTTTTTT
TTTT    @    TTT
TTTT C       TTT
TTTTTTTT     TTT
TTTTTTTT TTTTTTT
TTTTTTTT     K T
T        TTT TTT
T  TTTTT TTT TTT
T BTTTTT TT  TTT
T  TT        TTT
T  B     TT  TTT
T        TT  TTT
TTTTTTTT   B TTT
TTTTTTTTT    TTT
G#C#   C   TTTTT
TTTTTTTTTTTTTTTT